################
#======#=======#
#======##======#
#======###====##
=======###======
=======###======
#======#======##
#======#=======#
#======#=======#
################

