################
#======#=Y=====#
#==P==P##==X==##
#======###=====#
=======###=====#
======P###=P==##
#============X==
#===X=====Y=====
#===========####
#====X====X=#==#
#==#====#####==#
#======#===X===#
#==P==P#===P=Y=#
################







