################
#P=Y=========P=#
#=============##
####========X==#
===#=======####
=P=#=P====X===##
####=========P==
#========Y======
#===========####
#====P====Y=#=P#
#=======#####==#
#======#=======#
#==Y===#====Y==#
################







