################
#===#======#===#
#=P=#==P===#=P=#
############===#
==P=#=Y===Y#####
====#======#####
#####===Y=X##===
#===#X=====##P==
#=P=#======#####
#===#===X==##==#
#############==#
#=P#=P=#=P==#P=#
#==#===#====#==#
################







