#==P############
#=######=P=X=X=#
########==#==X=#
====#########==#
===########==###
===#######P=#==X
===##########=X=
===#P####P=##==Y
###############=
###############P
#=##############
###P###P=##P####
############==P=
################







