################
#====Y=##======#
#==P===##==X==##
#======###=====#
==Y==X=###=P===#
=======##====X##
==P==####X=====
====X=##===P#===
======##=====X==
=X====##====#==#
===#==#######==#
#==P==##=P=====#
########==X====#
################







