################
#=Y==P=#=P=====#
#====X=##==X==##
#======###=====#
==Y====###===X=#
===###=###====##
#======####=====
#===X=========P=
#=P===##########
#######=====#==#
#=P#==X=#####=P#
#==X=X=#===X==Y#
########=X==Y==#
################







