################
#===#=====X#===#
#=P=#==Y===#=P=#
#####=Y===X#####
==Y===Y==X===X=#
===X=X=Y====X==#
#####====X======
====#===Y=Y==X==
==P=#=X===Y=X==#
#####====Y=====#
#===Y==XY==#####
#X===Y=X===#===#
#==X====X=X#=P=#
################







