################
#======#=======#
#======##=====##
#======###=====#
==Y====###=====#
=======###====##
#=========X=====
#===X===========
#========Y==##=#
#===========#==#
#==#=X==#####==#
#======#=======#
#==Y===#=======#
################







